#######################################################################################
#                                                                                    E|
#                                                                                    S|
#                                                                                    C|
#                                                                                    A|
#                                                                                    P|
#                                                                                    E|
#                                                                                     #
#                                                                                     #
#                                                                                     #
#        ##############################################################################
#||||||||##############################################################################
#                                                                                     #
#                                                                                     #
#                                                                                     #
#                                                                                     #
#                                                                                     #
#                                                                                     #
#                                                                                     #
#                                                                                     #
#                                                                                     #
#################################        ##############################################
#################################||||||||##############################################
#                                                                                     #
#                                                                                     #
#                                                                                     #
#                                                                                     #
#                                                                                     #
#                                                                                     #
#                                                                                     #
#                                                                                     #
#                                                                                     #
#                                                                                     #
#                                                                                     #
#                                                                                     #
#                                                                                     #
#######################################################################################